
12  18
11  16

#################
        #       #
# ##### # ##### #
#   # # #     # #
# # # # ##### # #
#   # #       # # 
### # ####### # #
#   # #    #  # # 
# ### # ## # ####
#     # ##     
#################